# 偏好设置
【文件】→【偏好设置】→【外观】→【侧边栏】勾选侧边栏的大纲视图允许折叠和展开
【文件】→【偏好设置】→【编辑器】→【默认换行符】选择LF；【拼写检查】选择不使用拼写检查
【文件】→【偏好设置】→【图像】→【插入图片时】选择复制图片到./${filename}.assets 文件夹和勾选对本地位置的图片应用上述规则和勾选优先使用相对路径
【文件】→【偏好设置】→【Markdown】→【Markdown扩展语法】全部勾选；【空格与换行】勾选显示<br/>和选择忽略连续的空格与单个换行

# 快捷键
段落:
一级标题                段落→一级标题                  Ctrl+1
二级标题                段落→二级标题                  Ctrl+2
三级标题                段落→三级标题                  Ctrl+3
四级标题                段落→四级标题                  Ctrl+4
五级标题                段落→五级标题                  Ctrl+5
六级标题                段落→六级标题                  Ctrl+6
段落                       段落→段落                         Ctrl+0
提升标题级别         段落→提升标题级别            Ctrl+=
降低标题级别         段落→降低标题级别            Ctrl+-
插入表格                段落→表格→插入表格        Ctrl+T
下方插入行            段落→表格→下方插入行     Ctrl+Enter
删除行                   段落→表格→删除行            Ctrl+Shift+退格
代码块                   段落→代码块                      Ctrl+Shift+K
公式块                   段落→公式块                      Ctrl+Shift+M
有序列表               段落→有序列表                   Ctrl+Shift+[
无序列表              段落→无序列表                    Ctrl+Shift+]
增加缩进              段落→缩进→增加缩进          Ctrl+]
减少缩进              段落→缩进→减少缩进          Ctrl+[
格式:
加粗                    格式→加粗                              Ctrl+B
斜体                    格式→斜体                              Ctrl+I
下划线                格式→下划线                           Ctrl+U
删除线                格式→删除线                           Ctrl+Shift+5
代码                    格式→代码                              Ctrl+Shift+`
超链接                格式→超链接                           Ctrl+K
清除格式             格式→清除格式                       Ctrl+\
视图:
显示/隐藏侧边栏         视图→显示/隐藏侧边栏    Ctrl+Shift+L
查找/替换                                                           Ctrl+F
源代码模式                  视图→源代码模式           Ctrl+/
实际大小                     视图→实际大小               Ctrl+Shift+9
放大                            视图→放大                      Ctrl+Shift+=
缩放                            视图→缩放                      Ctrl+Shift+-

# 表情符号
语法                    效果
:smile:                 😄
:laughing:           😆
:+1:                    👍
:-1:                     👎
:clap:                  👏
